###################
#        #        #
#$** *** # *** **$#
# ** *** # *** ** #
#                 #
# ** * ***** * ** ###########
#    *   *   *             %#
#### *** * *** ##############
...# *       * #
...# * **.** * #
...#   *...*   #
...# * ***** * #
...# *       * #
#### * ***** * ####
#        *        #
# ** *** * *** ** #
#$ *     %     * $#
## * * ***** * * ##
#    *   *   *    #
# ****** * ****** #
#                 #
###################