################################################
#                                              #
############################################## #
#                                              #
# ##############################################
#                                              #
############################################## #
#                                              #
# ##############################################
#                                              #
############################################## #
#                                              #
# ##############################################
#                        %                     #
############################################## #
#                                              #
# ##############################################
#                                              #
############################################## #
#                                              #
# ##############################################
#                                              #
############################################## #
#                                              #
# ##############################################
#                                              #
################################################