################################################
#                                              #
#********************************** ********** #
#                                              #
# ***************** ***************************#
#                                              #
#************************************ ******** #
#                                              #
# ************* *******************************#
#                        @                     #
#********************************* *********** #
#                                              #
# ************ ********************************#
#                        %                     #
#*********************** ********************* #
#                                              #
# ******************************* *************#
#                        @                     #
#******* ************************************* #
#                                              #
# ************************************** ******#
#                                              #
#************* ******************************* #
#                                              #
# ********************** **********************#
#                                              #
################################################