###################
#        #        #
# ** *** # *** ** #
# ** *** # *** ** #
#                 #
# ** * ***** * ** #
#    *   *   *    #
#### *** * *** ####
...# *       * #
...# * **@** * #
...#   *@@@*   #
...# * ***** * #
...# *       * #
#### * ***** * ####
#        *        #
# ** *** * *** ** #
#  *     %     *  #
## * * ***** * * ##
#    *   *   *    #
# ****** * ****** #
#                 #
###################