###################
#        #        #
# ** *** # *** ** #
# ** *** # *** ** #
#                 #
# ** * ***** * ** #
#    *   *   *    #
#### *** * *** ####
   # *       * #
   # * ** ** * #
   #   *   *   #
   # * ***** * #
   # *       * #
#### * ***** * ####
#        *        #
# ** *** * *** ** #
#  *           *  #
## * * ***** * * ##
#    *   *   *    #
# ****** * ****** #
#                 #
###################